neural_stem_cells	01_neurons_fetal_brain
neurons	01_neurons_fetal_brain
brain_fetal	01_neurons_fetal_brain
parietal_lobe_fetal	01_neurons_fetal_brain
temporal_lobe_fetal	01_neurons_fetal_brain
occipital_lobe_fetal	01_neurons_fetal_brain
optic_nerve	02_nervous_system_adult_hindbrain
spinal_cord_fetal	02_nervous_system_adult_hindbrain
cerebellum_adult	02_nervous_system_adult_hindbrain
corpus_callosum_adult	02_nervous_system_adult_hindbrain
substantia_nigra_adult	02_nervous_system_adult_hindbrain
pons_adult	02_nervous_system_adult_hindbrain
spinal_cord_adult	02_nervous_system_adult_hindbrain
medulla_oblongata_adult	02_nervous_system_adult_hindbrain
locus_coeruleus_adult	02_nervous_system_adult_hindbrain
caudate_nucleus_adult	03_adult_forebrain
putamen_adult	03_adult_forebrain
diencephalon_adult	03_adult_forebrain
thalamus_adult	03_adult_forebrain
globus_pallidus_adult	03_adult_forebrain
amygdala_adult	03_adult_forebrain
hippocampus_adult	03_adult_forebrain
parietal_lobe_adult	03_adult_forebrain
medial_frontal_gyrus_adult	03_adult_forebrain
occipital_cortex_adult	03_adult_forebrain
medial_temporal_gyrus	03_adult_forebrain
cerebral_meninges_adult	03_adult_forebrain
brain_adult	03_adult_forebrain
medial_temporal_gyrus_adult	03_adult_forebrain
olfactory_region_adult	03_adult_forebrain
occipital_lobe_adult	03_adult_forebrain
nucleus_accumbens_adult	03_adult_forebrain
paracentral_gyrus_adult	03_adult_forebrain
insula_adult	03_adult_forebrain
frontal_lobe_adult	03_adult_forebrain
occipital_pole_adult	03_adult_forebrain
temporal_lobe_adult	03_adult_forebrain
postcentral_gyrus_adult	03_adult_forebrain
preadipocyte_-_perirenal	04_mesenchymal_mixed
adipocyte_-_perirenal	04_mesenchymal_mixed
tridermal_teratoma_cell_line	04_mesenchymal_mixed
sacrococcigeal_teratoma_cell_line	04_mesenchymal_mixed
smooth_muscle_cells_-_pulmonary_artery	04_mesenchymal_mixed
fibroblast_-_pulmonary_artery	04_mesenchymal_mixed
mesenchymal_stem_cells_-_whartons_jelly	04_mesenchymal_mixed
smooth_muscle_cells_-_umbilical_vein	04_mesenchymal_mixed
bone_marrow_stromal_cell_line	04_mesenchymal_mixed
osteoclastoma_cell_line	04_mesenchymal_mixed
sertoli_cells	04_mesenchymal_mixed
basal_cell_carcinoma_cell_line	04_mesenchymal_mixed
hepatic_mesenchymal_tumor_cell_line	04_mesenchymal_mixed
ewings_sarcoma_cell_line	04_mesenchymal_mixed
neurofibroma_cell_line	04_mesenchymal_mixed
spindle_cell_sarcoma_cell_line	04_mesenchymal_mixed
leiomyoblastoma_cell_line	05_sarcoma
extraskeletal_myxoid_chondrosarcoma_cell_line	05_sarcoma
adrenal_cortex_adenocarcinoma_cell_line	05_sarcoma
alveolar_cell_carcinoma_cell_line	05_sarcoma
large_cell_lung_carcinoma_cell_line	05_sarcoma
embryonic_pancreas_cell_line	05_sarcoma
giant_cell_carcinoma_cell_line	05_sarcoma
osteosarcoma_cell_line	05_sarcoma
pleomorphic_hepatocellular_carcinoma_cell_line	05_sarcoma
liposarcoma_cell_line	05_sarcoma
glioma_cell_line	05_sarcoma
astrocytoma_cell_line	05_sarcoma
lens_epithelial_cell_line	05_sarcoma
granulosa_cell_tumor_cell_line	05_sarcoma
papillary_adenocarcinoma_cell_line	05_sarcoma
thyroid_carcinoma_cell_line	05_sarcoma
meningioma_cell_line	05_sarcoma
fibrous_histiocytoma_cell_line	05_sarcoma
fibrosarcoma_cell_line	05_sarcoma
mixed_mullerian_tumor_cell_line	05_sarcoma
cholangiocellular_carcinoma_cell_line	05_sarcoma
pagetoid_sarcoma_cell_line	05_sarcoma
myxofibrosarcoma_cell_line	05_sarcoma
anaplastic_carcinoma_cell_line	05_sarcoma
schwannoma_cell_line	05_sarcoma
hepatic_sinusoidal_endothelial_cells	06_endothelial_cells
renal_glomerular_endothelial_cells	06_endothelial_cells
endothelial_cells_-_microvascular	06_endothelial_cells
endothelial_cells_-_lymphatic	06_endothelial_cells
endothelial_cells_-_thoracic	06_endothelial_cells
endothelial_cells_-_umbilical_vein	06_endothelial_cells
endothelial_cells_-_vein	06_endothelial_cells
endothelial_cells_-_artery	06_endothelial_cells
endothelial_cells_-_aortic	06_endothelial_cells
mesenchymal_precursor_cell_-_ovarian_cancer_metastasis	07_mesenchymal_stem_smooth_muscle_cells
mesenchymal_precursor_cell_-_ovarian_cancer_right_ovary	07_mesenchymal_stem_smooth_muscle_cells
mesenchymal_precursor_cell_-_ovarian_cancer_left_ovary	07_mesenchymal_stem_smooth_muscle_cells
mesenchymal_precursor_cell_-_bone_marrow	07_mesenchymal_stem_smooth_muscle_cells
mesenchymal_precursor_cell_-_cardiac	07_mesenchymal_stem_smooth_muscle_cells
mesenchymal_precursor_cell_-_adipose	07_mesenchymal_stem_smooth_muscle_cells
leiomyoma_cell_line	07_mesenchymal_stem_smooth_muscle_cells
mesothelial_cells	07_mesenchymal_stem_smooth_muscle_cells
smooth_muscle_cells_-_umbilical_artery	07_mesenchymal_stem_smooth_muscle_cells
fibroblast_-_cardiac	07_mesenchymal_stem_smooth_muscle_cells
smooth_muscle_cells_-_aortic	07_mesenchymal_stem_smooth_muscle_cells
smooth_muscle_cells_-_subclavian_artery	07_mesenchymal_stem_smooth_muscle_cells
smooth_muscle_cells_-_carotid	07_mesenchymal_stem_smooth_muscle_cells
smooth_muscle_cells_-_internal_thoracic_artery	07_mesenchymal_stem_smooth_muscle_cells
smooth_muscle_cells_-_coronary_artery	07_mesenchymal_stem_smooth_muscle_cells
smooth_muscle_cells_-_brachiocephalic	07_mesenchymal_stem_smooth_muscle_cells
mesenchymal_stem_cell_line	08_connective_tissue_muscle_cells
myoblast	08_connective_tissue_muscle_cells
pericytes	08_connective_tissue_muscle_cells
skeletal_muscle_cells_differentiated_into_myotubes_-_multinucleated	08_connective_tissue_muscle_cells
skeletal_muscle_cells	08_connective_tissue_muscle_cells
skeletal_muscle_satellite_cells	08_connective_tissue_muscle_cells
trabecular_meshwork_cells	08_connective_tissue_muscle_cells
fibroblast_-_conjunctival	08_connective_tissue_muscle_cells
keratocytes	08_connective_tissue_muscle_cells
mesenchymal_stem_cells_-_bone_marrow	08_connective_tissue_muscle_cells
fibroblast_-_lymphatic	08_connective_tissue_muscle_cells
smooth_muscle_cells_-_esophageal	08_connective_tissue_muscle_cells
smooth_muscle_cells_-_bronchial	08_connective_tissue_muscle_cells
mesenchymal_stem_cells_-_hepatic	08_connective_tissue_muscle_cells
hepatic_stellate_cells_lipocyte	08_connective_tissue_muscle_cells
mesenchymal_stem_cells_-_umbilical	08_connective_tissue_muscle_cells
cardiac_myocyte	08_connective_tissue_muscle_cells
iris_pigment_epithelial_cells	08_connective_tissue_muscle_cells
smooth_muscle_cells_-_brain_vascular	08_connective_tissue_muscle_cells
fibroblast_-_choroid_plexus	08_connective_tissue_muscle_cells
meningeal_cells	08_connective_tissue_muscle_cells
osteoblast_-_differentiated	08_connective_tissue_muscle_cells
smooth_muscle_cells_-_tracheal	08_connective_tissue_muscle_cells
hair_follicle_outer_root_sheath_cells	08_connective_tissue_muscle_cells
anulus_pulposus_cell	08_connective_tissue_muscle_cells
nucleus_pulposus_cell	08_connective_tissue_muscle_cells
adipocyte_-_subcutaneous	09_connective_tissue_integumental_cells
adipocyte_-_breast	09_connective_tissue_integumental_cells
adipocyte_-_omental	09_connective_tissue_integumental_cells
chondrocyte_-_re_diff	09_connective_tissue_integumental_cells
synoviocyte	09_connective_tissue_integumental_cells
chondrocyte_-_de_diff	09_connective_tissue_integumental_cells
tenocyte	09_connective_tissue_integumental_cells
normal_intestinal_epithelial_cell_line	09_connective_tissue_integumental_cells
normal_embryonic_palatal_mesenchymal_cell_line	09_connective_tissue_integumental_cells
smooth_muscle_cells_-_colonic	09_connective_tissue_integumental_cells
smooth_muscle_cells_-_prostate	09_connective_tissue_integumental_cells
prostate_stromal_cells	09_connective_tissue_integumental_cells
mesenchymal_stem_cells_-_amniotic_membrane	09_connective_tissue_integumental_cells
multipotent_cord_blood_unrestricted_somatic_stem_cells	09_connective_tissue_integumental_cells
smooth_muscle_cells_-_uterine	09_connective_tissue_integumental_cells
fibroblast_-_skin_walker_warburg	09_connective_tissue_integumental_cells
pancreatic_stromal_cells	09_connective_tissue_integumental_cells
preadipocyte_-_omental	09_connective_tissue_integumental_cells
preadipocyte_-_breast	09_connective_tissue_integumental_cells
fibroblast_-_skin_normal	09_connective_tissue_integumental_cells
fibroblast_-_skin_dystrophia_myotonica	09_connective_tissue_integumental_cells
fibroblast_-_skin_spinal_muscular_atrophy	09_connective_tissue_integumental_cells
hair_follicle_dermal_papilla_cells	09_connective_tissue_integumental_cells
olfactory_epithelial_cells	09_connective_tissue_integumental_cells
fibroblast_-_periodontal_ligament_adult	09_connective_tissue_integumental_cells
fibroblast_-_gingival	09_connective_tissue_integumental_cells
fibroblast_-_periodontal_ligament_fetal	09_connective_tissue_integumental_cells
osteoblast	09_connective_tissue_integumental_cells
fibroblast_-_aortic_adventitial	09_connective_tissue_integumental_cells
preadipocyte_-_subcutaneous	09_connective_tissue_integumental_cells
preadipocyte_-_visceral	09_connective_tissue_integumental_cells
mesenchymal_stem_cells_-_adipose	09_connective_tissue_integumental_cells
fibroblast_-_dermal	09_connective_tissue_integumental_cells
cd4+_t_cells	10_lymphocytes
natural_killer_cells	10_lymphocytes
cd8+_t_cells	10_lymphocytes
cd4+cd25+cd45ra+_naive_regulatory_t_cells	10_lymphocytes
cd4+cd25-cd45ra-_memory_conventional_t_cells	10_lymphocytes
cd4+cd25+cd45ra-_memory_regulatory_t_cells	10_lymphocytes
cd4+cd25-cd45ra+_naive_conventional_t_cells	10_lymphocytes
cd14+_monocytes	11_myeloid_leukocytes
mast_cell	11_myeloid_leukocytes
langerhans_cells_immature	11_myeloid_leukocytes
langerhans_cells_migratory	11_myeloid_leukocytes
cd19+_b_cells	11_myeloid_leukocytes
dendritic_cells_-_plasmacytoid	11_myeloid_leukocytes
cd14-cd16+_monocytes	11_myeloid_leukocytes
cd14+cd16+_monocytes	11_myeloid_leukocytes
cd14+cd16-_monocytes	11_myeloid_leukocytes
neutrophils	11_myeloid_leukocytes
whole_blood_ribopure	11_myeloid_leukocytes
peripheral_blood_mononuclear_cells	11_myeloid_leukocytes
basophils	11_myeloid_leukocytes
b_lymphoblastoid_cell_line	12_lymphocytes_of_b_lineage
b_cell_line	12_lymphocytes_of_b_lineage
xeroderma_pigentosum_b_cell_line	12_lymphocytes_of_b_lineage
plasma_cell_leukemia_cell_line	12_lymphocytes_of_b_lineage
splenic_lymphoma_with_villous_lymphocytes_cell_line	12_lymphocytes_of_b_lineage
non_t_non_b_acute_lymphoblastic_leukemia_all_cell_line	12_lymphocytes_of_b_lineage
lymphoma_malignant_hairy_b-cell_cell_line	12_lymphocytes_of_b_lineage
acute_lymphoblastic_leukemia_b-all_cell_line	12_lymphocytes_of_b_lineage
diffuse_large_b-cell_lymphoma_cell_line	12_lymphocytes_of_b_lineage
burkitts_lymphoma_cell_line	12_lymphocytes_of_b_lineage
chronic_lymphocytic_leukemia_t-cll_cell_line	13_lymphoma
hodgkins_lymphoma_cell_line	13_lymphoma
acute_lymphoblastic_leukemia_t-all_cell_line	13_lymphoma
hairy_cell_leukemia_cell_line	13_lymphoma
mycosis_fungoides_t_cell_lymphoma_cell_line	13_lymphoma
adult_t-cell_leukemia_cell_line	13_lymphoma
anaplastic_large_cell_lymphoma_cell_line	13_lymphoma
myeloma_cell_line	13_lymphoma
lymphangiectasia_cell_line	13_lymphoma
hereditary_spherocytic_anemia_cell_line	13_lymphoma
nk_t_cell_leukemia_cell_line	13_lymphoma
endothelial_progenitor_cells	14_immune_organs
dendritic_cells_-_monocyte_immature_derived	14_immune_organs
macrophage_-_monocyte_derived	14_immune_organs
thymus_fetal	14_immune_organs
thymus_adult	14_immune_organs
blood_adult	14_immune_organs
lymph_node_adult	14_immune_organs
spleen_fetal	14_immune_organs
spleen_adult	14_immune_organs
reticulocytes	15_myeloid_leukemia
chronic_myelogenous_leukemia_cml_cell_line	15_myeloid_leukemia
acute_myeloid_leukemia_fab_m6_cell_line	15_myeloid_leukemia
leukemia_chronic_megakaryoblastic__cell_line	15_myeloid_leukemia
acute_myeloid_leukemia_fab_m7_cell_line	15_myeloid_leukemia
acute_myeloid_leukemia_fab_m0_cell_line	15_myeloid_leukemia
acute_myeloid_leukemia_fab_m1_cell_line	15_myeloid_leukemia
acute_myeloid_leukemia_fab_m4_cell_line	15_myeloid_leukemia
acute_myeloid_leukemia_fab_m2_cell_line	15_myeloid_leukemia
cd34+_stem_cells_-_adult_bone_marrow_derived	15_myeloid_leukemia
acute_myeloid_leukemia_fab_m5_cell_line	15_myeloid_leukemia
acute_myeloid_leukemia_fab_m4eo_cell_line	15_myeloid_leukemia
biphenotypic_b_myelomonocytic_leukemia_cell_line	15_myeloid_leukemia
acute_myeloid_leukemia_fab_m3_cell_line	15_myeloid_leukemia
myelodysplastic_syndrome_cell_line	15_myeloid_leukemia
hepatoblastoma_cell_line	16_endo-epithelial_cells
hepatocellular_carcinoma_cell_line	16_endo-epithelial_cells
colon_carcinoma_cell_line	16_endo-epithelial_cells
intestinal_epithelial_cells_polarized	16_endo-epithelial_cells
prostate_epithelial_cells	16_endo-epithelial_cells
rectal_cancer_cell_line	17_adenocarcinoma
adenocarcinoma_cell_line	17_adenocarcinoma
signet_ring_carcinoma_cell_line	17_adenocarcinoma
tubular_adenocarcinoma_cell_line	17_adenocarcinoma
lung_adenocarcinoma_cell_line	17_adenocarcinoma
bile_duct_carcinoma_cell_line	17_adenocarcinoma
epididymis_adult	18_male_reproductive_organs
testis_adult	18_male_reproductive_organs
clontech_human_universal_reference_total_rna	18_male_reproductive_organs
kidney_adult	19_liver_kidney
kidney_fetal	19_liver_kidney
universal_rna_-_human_normal_tissues_biochain	19_liver_kidney
sabiosciences_xpressref_human_universal_total_rna	19_liver_kidney
liver_fetal	19_liver_kidney
hepatocyte	19_liver_kidney
liver_adult	19_liver_kidney
duodenum_fetal	20_gastrointestinal_system
colon_fetal	20_gastrointestinal_system
small_intestine_fetal	20_gastrointestinal_system
small_intestine_adult	20_gastrointestinal_system
colon_adult	20_gastrointestinal_system
pancreas_adult	20_gastrointestinal_system
rectum_fetal	20_gastrointestinal_system
appendix_adult	20_gastrointestinal_system
gall_bladder_adult	20_gastrointestinal_system
stomach_fetal	20_gastrointestinal_system
heart_-_tricuspid_valve_adult	21_heart
heart_-_pulmonic_valve_adult	21_heart
heart_adult	21_heart
heart_-_mitral_valve_adult	21_heart
left_ventricle_adult	21_heart
left_atrium_adult	21_heart
heart_fetal	21_heart
diaphragm_fetal	22_mouth_throat_skeletal_muscle_tissue
skeletal_muscle_fetal	22_mouth_throat_skeletal_muscle_tissue
skeletal_muscle_-_soleus_muscle	22_mouth_throat_skeletal_muscle_tissue
skeletal_muscle_adult	22_mouth_throat_skeletal_muscle_tissue
skin_fetal	22_mouth_throat_skeletal_muscle_tissue
umbilical_cord_fetal	22_mouth_throat_skeletal_muscle_tissue
throat_adult	22_mouth_throat_skeletal_muscle_tissue
trachea_adult	22_mouth_throat_skeletal_muscle_tissue
throat_fetal	22_mouth_throat_skeletal_muscle_tissue
trachea_fetal	22_mouth_throat_skeletal_muscle_tissue
tonsil_adult	22_mouth_throat_skeletal_muscle_tissue
esophagus_adult	22_mouth_throat_skeletal_muscle_tissue
penis_adult	22_mouth_throat_skeletal_muscle_tissue
tongue_adult	22_mouth_throat_skeletal_muscle_tissue
tongue_fetal	22_mouth_throat_skeletal_muscle_tissue
aorta_adult	23_lung
lung_right_lower_lobe_adult	23_lung
lung_fetal	23_lung
lung_adult	23_lung
thyroid_fetal	24_glands_internal_genitalia
thyroid_adult	24_glands_internal_genitalia
parotid_gland_adult	24_glands_internal_genitalia
salivary_gland_adult	24_glands_internal_genitalia
submaxillary_gland_adult	24_glands_internal_genitalia
ductus_deferens_adult	24_glands_internal_genitalia
seminal_vesicle_adult	24_glands_internal_genitalia
uterus_fetal	24_glands_internal_genitalia
ovary_adult	24_glands_internal_genitalia
cervix_adult	24_glands_internal_genitalia
uterus_adult	24_glands_internal_genitalia
breast_adult	24_glands_internal_genitalia
dura_mater_adult	24_glands_internal_genitalia
vein_adult	24_glands_internal_genitalia
adipose_tissue_adult	24_glands_internal_genitalia
vagina_adult	24_glands_internal_genitalia
smooth_muscle_adult	24_glands_internal_genitalia
prostate_adult	24_glands_internal_genitalia
bladder_adult	24_glands_internal_genitalia
pineal_gland_adult	25_pineal_gland_eye
eye_fetal	25_pineal_gland_eye
retina_adult	25_pineal_gland_eye
retinoblastoma_cell_line	26_neuron-associated_cells_cancer
medulloblastoma_cell_line	26_neuron-associated_cells_cancer
merkel_cell_carcinoma_cell_line	26_neuron-associated_cells_cancer
carcinoid_cell_line	26_neuron-associated_cells_cancer
neuroblastoma_cell_line	26_neuron-associated_cells_cancer
neuroectodermal_tumor_cell_line	26_neuron-associated_cells_cancer
testicular_germ_cell_embryonal_carcinoma_cell_line	26_neuron-associated_cells_cancer
teratocarcinoma_cell_line	26_neuron-associated_cells_cancer
argyrophil_small_cell_carcinoma_cell_line	26_neuron-associated_cells_cancer
gastric_cancer_cell_line	26_neuron-associated_cells_cancer
pituitary_gland_adult	26_neuron-associated_cells_cancer
small_cell_lung_carcinoma_cell_line	26_neuron-associated_cells_cancer
small_cell_gastrointestinal_carcinoma_cell_line	26_neuron-associated_cells_cancer
melanoma_cell_line	27_astrocytes_pigment_cells
melanocyte	27_astrocytes_pigment_cells
retinal_pigment_epithelial_cells	27_astrocytes_pigment_cells
lens_epithelial_cells	27_astrocytes_pigment_cells
ciliary_epithelial_cells	27_astrocytes_pigment_cells
astrocyte_-_cerebral_cortex	27_astrocytes_pigment_cells
astrocyte_-_cerebellum	27_astrocytes_pigment_cells
cord_blood_derived_cell_line	28_neuroectodermal_tumors_sarcoma
embryonic_kidney_cell_line	28_neuroectodermal_tumors_sarcoma
mesothelioma_cell_line	28_neuroectodermal_tumors_sarcoma
hep-2_cells	28_neuroectodermal_tumors_sarcoma
epitheloid_cancer_cell_line	28_neuroectodermal_tumors_sarcoma
anaplastic_squamous_cell_carcinoma_cell_line	28_neuroectodermal_tumors_sarcoma
synovial_sarcoma_cell_line	28_neuroectodermal_tumors_sarcoma
rhabdomyosarcoma_cell_line	28_neuroectodermal_tumors_sarcoma
wilms_tumor_cell_line	28_neuroectodermal_tumors_sarcoma
peripheral_neuroectodermal_tumor_cell_line	28_neuroectodermal_tumors_sarcoma
neuroepithelioma_cell_line	28_neuroectodermal_tumors_sarcoma
carcinosarcoma_cell_line	28_neuroectodermal_tumors_sarcoma
small_cell_cervical_cancer_cell_line	28_neuroectodermal_tumors_sarcoma
somatostatinoma_cell_line	28_neuroectodermal_tumors_sarcoma
salivary_acinar_cells	29_epithelial_cells
keratoacanthoma_cell_line	29_epithelial_cells
cervical_cancer_cell_line	29_epithelial_cells
nasal_epithelial_cells	29_epithelial_cells
corneal_epithelial_cells	29_epithelial_cells
esophageal_epithelial_cells	29_epithelial_cells
keratinocyte_-_oral	29_epithelial_cells
bronchial_epithelial_cell	29_epithelial_cells
tracheal_epithelial_cells	29_epithelial_cells
urothelial_cells	29_epithelial_cells
small_airway_epithelial_cells	29_epithelial_cells
mammary_epithelial_cell	29_epithelial_cells
gingival_epithelial_cells	29_epithelial_cells
mallassez-derived_cells	29_epithelial_cells
sebocyte	29_epithelial_cells
keratinocyte_-_epidermal	29_epithelial_cells
pancreatic_carcinoma_cell_line	30_extraembryonic_membrane
choriocarcinoma__cell_line	30_extraembryonic_membrane
placenta_adult	30_extraembryonic_membrane
chorionic_membrane_cells	30_extraembryonic_membrane
amniotic_membrane_cells	30_extraembryonic_membrane
serous_cystadenocarcinoma_cell_line	31_epithelial_cells_of_kidney_uterus
renal_cell_carcinoma_cell_line	31_epithelial_cells_of_kidney_uterus
serous_adenocarcinoma_cell_line	31_epithelial_cells_of_kidney_uterus
clear_cell_carcinoma_cell_line	31_epithelial_cells_of_kidney_uterus
endometrial_cancer_cell_line	31_epithelial_cells_of_kidney_uterus
placental_epithelial_cells	31_epithelial_cells_of_kidney_uterus
amniotic_epithelial_cells	31_epithelial_cells_of_kidney_uterus
alveolar_epithelial_cells	31_epithelial_cells_of_kidney_uterus
renal_mesangial_cells	31_epithelial_cells_of_kidney_uterus
renal_proximal_tubular_epithelial_cell	31_epithelial_cells_of_kidney_uterus
renal_epithelial_cells	31_epithelial_cells_of_kidney_uterus
renal_cortical_epithelial_cells	31_epithelial_cells_of_kidney_uterus
maxillary_sinus_tumor_cell_line	32_lung_epithelium_lung_cancer
breast_carcinoma_cell_line	32_lung_epithelium_lung_cancer
bronchioalveolar_carcinoma_cell_line	32_lung_epithelium_lung_cancer
papillotubular_adenocarcinoma_cell_line	32_lung_epithelium_lung_cancer
mucinous_adenocarcinoma_cell_line	32_lung_epithelium_lung_cancer
gall_bladder_carcinoma_cell_line	32_lung_epithelium_lung_cancer
ductal_cell_carcinoma_cell_line	32_lung_epithelium_lung_cancer
prostate_cancer_cell_line	32_lung_epithelium_lung_cancer
transitional-cell_carcinoma_cell_line	32_lung_epithelium_lung_cancer
malignant_trichilemmal_cyst_cell_line	32_lung_epithelium_lung_cancer
squamous_cell_carcinoma_cell_line	32_lung_epithelium_lung_cancer
epidermoid_carcinoma_cell_line	32_lung_epithelium_lung_cancer
oral_squamous_cell_carcinoma_cell_line	32_lung_epithelium_lung_cancer
bronchogenic_carcinoma_cell_line	32_lung_epithelium_lung_cancer
glassy_cell_carcinoma_cell_line	32_lung_epithelium_lung_cancer
squamous_cell_lung_carcinoma_cell_line	32_lung_epithelium_lung_cancer
large_cell_non-keratinizing_squamous_carcinoma_cell_line	32_lung_epithelium_lung_cancer
acantholytic_squamous_carcinoma_cell_line	32_lung_epithelium_lung_cancer
pharyngeal_carcinoma_cell_line	32_lung_epithelium_lung_cancer
bronchial_squamous_cell_carcinoma_cell_line	32_lung_epithelium_lung_cancer
